EMWEPEMEEPWEMMMMEEPW
MWWPMEEPMWEMPPWWPMEM
MWMMEPPMEEEEPEPWPWPP
WEEWMEWPMPWMMEMPEPPW
PPEEWPWMPMWMMEPWEPPE
EMEEMMPEEWWEMMPEPMEE
WEMWEEPWMPMPPMWMEMMP
SWMWWEEMWPMPMMMEPMMW
MMPWMWEMMMWPPWWPPWWW
PEMWMPPWMMEWMMPPPPEP
EWEMWMWMMPEWPEEPPPPE
PWPWEEEEWPEWPWEWMMWP
EMPMWEEEWMPWMPWMEMEW
WEMEMMPEWWPPWPWEPWEP
MWWMPEWMPMMEMMWEEMWM
MEMWMMPPEEMEWMPPEEPM
MWWMMPMEPMEWPWPEPMPP
EMPWPMPEEPEEEPWMEMWP
WEWEPEEEWPEEMWEMMPPP
MPEWPEMMWMWPWMWWEWPW
